"Transect","Status","MCAV","OFAV","PAST","PSTR","SSID","Total"
"CBC30N","Bleached",1,1,3,1,1,7
"CURLEW","Bleached",2,1,0,2,0,5
"CURLEW","Not Bleached",1,0,0,0,0,1
"LAGOON","Bleached",3,0,3,2,2,10
"LAGOON","Not Bleached",0,2,0,0,0,2
"SR30N","Bleached",3,1,2,0,3,9
"SR30N","Not Bleached",0,1,1,0,0,2
"Total","Bleached",9,3,8,5,6,31
"Total","Not Bleached",1,3,1,0,0,5
"Total","Total",10,6,9,5,6,36
